あ	乎 余 僕 吾 呼 咨 嗚呼 嗟 噫 妾 婀 安 己 我 朕 畔 痾 網 臈 英 足 阿 鞅 鳴
あり	蟻
い	五 五十 井 以 伊 伍 位 依 偉 儞 医 印 去 壓 壱 夷 委 威 宿 寐 寝 射 居 屈 己 已 強 往 怡 意 懿 斎 易 曰 気 汝 為 烏 猪 獮 異 移 納 膽 萎 謂 韋 馬声 馬聲
いぇ	兄 叡 吉 延 所 曳 曵 枝 柄 江 生 衣 被 要 見 遙 遥 長
いかり	慍
う	于 優 免 兎 内 卯 右 埿 宇 座 得 打 有 棘 汙 海 烏 獲 盂 禹 紆 羽 菟 豊 雨 雲 鳥 鵜 鸕 𤞣
うつつ	得管
え	亜 依 叡 可愛 哀 善 埃 役 得 愛 敢 朴 榎 江 浿 獲 疫 移 胞 荏 衛 衣 鬼
お	乙 億 御 忍 応 恩 意 憶 應 於 淤 隠 飫
おろし	下
か	下 且 乎 也 介 伽 何 佳 加 勝 化 可 右 呵 哉 哥 哿 嘉 堅 夏 奇 家 川 左 干 彼 得 敢 日 曷 有 架 柯 梶 楫 歌 歟 気 汗 河 湯 漢 珂 瓮 甲 疑 箇 耶 肝 舸 花 芳 荷 華 蚊 訶 謌 賀 賊 軻 迦 金 閑 霞 香 高 髪 鹿 𪫧
かしき	炊
かも	鴨
かり	切木四
が	之 何 俄 加 可 奇 宜 峨 川 我 歌 歟 河 臥 荷 蚊 蛾 賀 迦 雅 餓 香 駕 髪 鵝 鹿
き	鬼
:き乙	城 基 墓 奇 寄 己 帰 幾 忌 既 旣 木 材 枝 椒 椽 槨 樹 機 歸 気 疑 癸 紀 綺 興 記 貴 騎 黄
:き甲	企 伎 來 到 刻 剋 割 吉 妓 寸 岐 己 帰 拭 擐 支 服 来 杵 枳 棄 気 着 祁 祇 祗 置 耆 聘 著 蒙 蓋 衣 被 貴 赴 酒 領
:ぎ乙	匹 宜 擬 木 椽 疑 紀 義
:ぎ甲	世 企 伎 儀 吉 君 寸 岐 支 杵 枳 祇 祗 耆 芸 藝 蟻 𡺸
く	:cjkvi:⿰糹勾 丘 中 久 九 休 伯 供 倶 傴 公 具 勾 区 口 句 君 国 奇 奥 孔 屢 探 救 敢 旧 来 杼 橡 求 玖 矩 窶 糺 絇 群 苦 菟 衢 訓 鳩
くく	八十一
ぐ	久 具 弘 愚 来 求 紅 虞 遇 隅
け	支
:け乙	下 介 凱 卜 占 居 希 愷 慨 戒 挙 擧 既 旣 日 明 木 概 毛 気 消 滅 笥 該 銷 開 階 食 飼
:け甲	介 価 係 價 啓 奚 宅 家 来 異 盖 着 祁 稽 結 蓋 計 谿 賈 霓 鶏
:げ乙	㝵 介 偈 削 宜 宣 既 毛 気 消 牙 皚 碍 礙 笥 義
:げ甲	下 夏 奚 牙 祁 雅 霓 鶏
こ	垝
:こ乙	与 今 凝 処 去 地 居 巨 己 忌 拠 挙 據 擧 是 木 来 樹 此 渠 興 莒 虚 許 詐
:こ甲	侯 児 兒 卵 古 固 姑 子 孤 小 庫 故 枯 狐 祜 篭 籠 粉 胡 顧 高
:ご乙	其 凝 居 己 御 期 木 碁 語 馭
:ご甲	五 候 児 卵 吾 呉 娯 子 庫 後 悟 故 梧 篭 籠 胡 虞 誤
さ	也 令 佐 作 匝 嗟 姐 娑 射 小 左 差 戔 所 政 散 方 旦 柴 棹 沙 浅 狭 猨 猿 瑳 磋 祥 積 紗 羅 者 舎 草 裟 語 迮 酢 麻
さが	相
ささ	神楽声
ざ	不 佐 坐 奘 奢 娑 射 座 弉 来 残 狭 社 耶 蔵 装 謝 蹔 邪 麻
し	之 事 二二 令 伺 使 侍 信 偲 僧 准 刺 叱 史 司 嗣 嗤 四 在 塩 士 失 始 姿 子 寒 寺 尸 屍 屣 峙 巳 市 師 式 忍 志 思 慈 所 指 支 斗 斯 新 施 旨 時 有 期 柴 柿 次 歌 此 歯 死 殺 氏 水 泪 津 清 為 牛 璽 矢 知 石 磯 礎 礒 示 祗 私 科 糸 紙 級 紫 絁 羊蹄 肆 胝 脂 脚 自 至 色 芝 茲 著 葦 蒂 詞 試 詩 貲 資 賜 足 辛 辞 進 雌
しし	十六
しな	信
じ	下 不 事 仕 侍 児 兒 勿 司 士 子 字 寺 尓 尺 尽 師 弐 弗 志 慈 斯 時 未 橋 次 母 滋 爾 珥 示 緇 耳 自 至 茸 賦 路 辞 非 餌
す	主 令 住 取 周 守 寸 崇 州 巣 房 所 提 数 春 林 栖 樔 樟 殊 沒 沙 洲 渚 為 爪 珠 秀 種 簀 簾 素 臼 蒭 輸 酒 酢 須 食 首
ず	不 儒 勿 受 孺 巣 弗 従 授 未 樔 殊 無 簀 聚 莫 豆 酢 需 非 靡 須
せ	世 令 作 兄 制 剤 勢 可 士 夫 宣 弟 所 斉 施 旋 是 柵 栖 湍 瀬 為 狭 石花 細 絞 背 脊 著 西 諾 迫 酒 須 齊
ぜ	世 噬 是 湍 瀬 筮
:そ乙	也 僧 其 具 則 増 層 彼 思 憎 所 曽 曾 服 歟 焉 背 苑 藻 行 衣 襲 諸 賊 贈
:そ甲	十 嗽 宗 巷 拾 泝 石 磯 礒 祖 素 蘇 追馬 麻 祖
:ぞ乙	也 叙 如 存 年 序 敍 曽 歟 矣 罇 耶 茹 賊 鋤 鐏
:ぞ甲	俗
た	丹 他 令 侈 党 咫 哆 堕 多 大 太 帯 廂 当 手 拕 掌 板 柁 檀 滞 田 痛 立 粮 而 耕 詫 誰 陀 陁 駄
だ	儴 儾 嚢 囊 堕 多 大 太 娜 手 拕 田 道 陀 陁 駄 駝 騨
ち	㨖 乳 仟 内 千 地 市 手 智 枚 池 治 直 知 稚 笞 至 致 茅 血 路 遅 道 達 鉤 陳 雉 風 馳 驢
ぢ	乳 千 口 地 尼 年 径 恥 持 施 旎 智 歳 沈 治 泥 父 直 知 耻 膩 舅 茅 路 近 遅 道 鉤 雉
つ	ツ 之 免 内 匹 口 唾 図 土 屠 川 州 徒 月 木 歳 津 片 疋 突 箇 管 茅 菟 覩 豆 追 途 逗 通 都 闘 隻 領 頭 鬪
つる	鶴
づ	出 図 弩 徒 津 菟 蝦 豆 逗 遣 都 集 頭
て	代 以 価 堤 天 太 帝 幣 底 弖 戸 手 提 棄 氐 泥 直 義 而 諦 題 𫢏
で	乞 代 伝 低 出 埿 堤 天 底 庭 弖 弟 手 提 殿 氐 泥 涅 田 而 耐 袂 袖 𫢏
:と乙	㔁 与 且 人 共 冬 十 及 台 塗 声 屠 常 并 弟 得 捕 杼 止 澄 登 等 縢 臺 與 苔 苫 藤 豊 跡 迹 鄧 音 飛 騰 鳥 鷹
:と甲	刀 利 図 圖 土 堵 塗 外 妬 屠 度 徒 戸 扉 斗 杜 渡 疾 砥 砺 礪 聡 聰 覩 速 都 鄙 鋒 鋭 門 間
:ど乙	十 奴 常 廼 怒 抒 杼 止 特 登 等 縢 耐 苔 藤 跡 迹 雖 騰
:ど甲	利 前 土 外 奴 度 怒 戸 斗 月 渡 神 速 門
な	七 不 中 乃 之 何 儺 内 勿 半 南 去 号 名 味 嘗 声 奈 奴 娜 字 寧 己 无 汝 波 浪 無 甞 男 称 穴 納 莫 菜 那 野 長 阿 難 魚
なつかし	夏樫
に	不 両 丹 之 乎 二 于 人 仁 以 任 似 何 儞 児 去 及 和 土 在 尓 尼 干 弐 所 於 日 柔 焉 煎 煑 煮 爾 珥 瓊 粉 而 耳 苞 荷 負 迩 邇 餌
ぬ	不 儒 努 去 奴 宿 寐 寝 布 弩 怒 未 柔 沼 沾 渟 濃 濕 犬 瓊 眠 蕤 被 農 野 霑 香
ね	不 丹 乃 哭 啼 喧 埿 声 姉 子 宿 寐 寝 尼 山 峯 嶺 年 根 泣 泥 涅 然 眠 睡 祢 禰 稲 莫 音 鳴
:の乙	乃 之 仍 告 廼 笑 笶 箆 箟 篦 能 荷 野 𣏾
:の甲	努 奴 弩 怒 濃 郊 野
は	之 伯 伴 倍 八 具 刃 刄 則 半 叵 土 婆 巴 幡 房 播 方 早 末 栗 歯 毎 沫 泊 波 泮 皤 皮 盤 石 破 磐 簸 絆 羽 者 芳 葉 薄 跛 速 防 隻 食 麓
ば	之 伐 刃 則 婆 幡 庭 播 歯 波 磨 縻 羽 者 荷 葉 薄 馬 魔 麼
:ひ乙	乾 備 嚏 妃 干 彼 悲 斐 樋 涸 火 熯 燭 祕 秘 簸 肥 被 費 非 飛 鳴
:ひ甲	会 匱 卑 原 合 土 埿 妣 嬪 巾 必 息 日 桧 檜 比 毗 毘 氷 烏 相 臂 譬 負 賓 辟 遇 避 鄙 霊 飯
び	夫 府 扶 文 柔 歩 部
:び乙	乾 傍 備 媚 必 悽 斐 火 眉 縻 肥 辺 非 飛
:び甲	妣 婢 寐 弥 弭 彌 日 比 毗 毘 氷 飯 鼻
ふ	上 不 乾 伝 俯 原 合 否 吹 圃 夫 婦 富 封 巫 布 府 扶 振 敷 斑 普 村 柎 歴 浮 父 生 甫 田 相 符 経 腐 補 言 負 賦 赴 踏 輔 部 雑 零 風 鯽
ぶ	不 儛 夫 奉 婦 布 府 扶 文 服 柔 武 歩 浮 父 生 矛 符 節 経 蜂音 豊 部 風 騖 鶩
:へ乙	:UK-20900 上 俳 倍 戸 拜 拝 於 杯 枻 歴 沛 珮 瓦缶 瓮 甕 経 經 綜 缶 缻 背 舳 苴 貫 逕 閇 閉 陪 頭
:へ甲	伯 俾 反 宅 家 幣 平 弁 弊 敝 敞 方 獘 甕 畔 蔽 覇 辨 辺 返 遍 邊 部 重 陛 隔 鞞 鼙
:べ乙	倍 可 応 戸 拝 毎 瓮 謎 陪
:べ甲	便 別 婢 弁 弊 敞 畔 謎 轂 辨 辺 部 隔 鼙
ほ	㶱 乏 保 倍 凡 品 報 大 宝 富 寶 布 廬 弗 抱 方 朋 本 歩 火 焔 熛 燄 番 発 神 穎 穿 菩 蕃 袍 裒 補 褒 譜 費 陪
:ほ乙	太 帆 百 穂
:ほ甲	百 穂
ぼ	保 凡 慕 暮 朋 母 煩 爐 番 簿 粒 菩 蕃 裒 褒
ぽ	煩 番 菩 蕃
ま	万 二 亦 信 前 又 可 喚犬 坐 天 孫 尼 摩 昧 暇 末 檀 満 目 真 眼 磨 莫 莽 財 間 際 面 馬 鬼 魔 麻 麼 𦵧
まく	巻
み	㢱 㫆 旀 𣃥
:み乙	体 味 子 実 實 寿 尾 廻 微 未 箕 菓 身 躬 転
:み甲	三 化 参 官 宮 寐 察 屯 弥 弭 彌 御 敏 望 民 水 海 湄 満 瀰 皇 監 省 看 眷 睨 瞻 矚 祇 神 綱 美 脉 臣 見 視 覧 覩 観 鑑 閲 視
む	且 令 儛 六 務 夢 寐 将 弥 悶 慕 所 擬 敢 无 有 模 欲 武 水 無 牛鳴 牟 生 産 監 臨 茂 試 謀 身 陸 霧 鵡 麻
め	㢱 㫆 旀 𣃥
:め乙	令 妹 将 昧 晩 未 梅 楽 毎 海 海藻 浼 瑇 目 眼 米 迷 雨
:め甲	召 咩 喚 売 女 妃 妻 姫 婦 媛 孁 牝 綿 見 謎 賣 迷 陰 雌 面 馬
も	亦 墓 如 念 悶 慕 摸 暮 梅 模 焉 焼 燎 目 維 莽 菨 表 裾 謀 謨
:も乙	勿 哭 喪 忘 文 方 望 母 物 茂 藻 裙 裳 記 門 面
:も甲	哭 問 妹 木 毛 畝 聞 蒙 藻 雲
や	乎 也 八 哉 夜 宇 室 家 射 屋 怜 捌 掖 揶 文 椰 楊 歟 殿 瑘 益 矢 破 祖 移 窟 笶 箭 綾 耶 聴 舎 野 陽
ゆ	喩 庾 弓 往 従 忌 愈 所 斎 楡 油 湯 瑜 由 結 自 臾 被 踰 遊
:よ乙	与 世 予 代 余 依 俗 可 吉 呼 哉 善 四 天 好 宜 寿 尋 已 時 歯 歳 生 節 耶 肆 與 葉 誉 譽 豫 運 預 餘 齢
:よ甲	夕 夜 宵 容 宿 庸 欲 用 遙 遥
ら	佾 刕 卜 囉 在 攞 有 柄 楽 樂 浦 浪 等 羅 良 荒 莫 裏 輩 邏 郎 部 騾
らむ	覧
り	人 入 利 口 吏 哆 唎 在 履 所 有 李 梨 煎 理 箇 篇 納 織 被 裏 許 里 釐 降 隣 離 驪 鳥
る	入 受 在 婁 屡 屢 廻 所 有 楼 樓 流 漏 煎 琉 瑠 留 盧 蘆 虆 被 類 魯 鹵
れ	余 例 信 列 在 寸 戻 戾 有 村 烈 煎 礼 禮 等 連 領 黎
:ろ乙	侶 勒 呂 廬 慮 樓 稜 里 閭 露
:ろ甲	婁 楼 樓 漏 盧 路 露 魯
わ	丸 倭 勾 口 吾 和 委 宛 己 我 曲 沫 涴 獲 王 輪 過
ゐ	:hng36-824 㘴 井 亥 位 偉 卒 坐 委 威 宿 將 尉 居 帷 座 為 爲 猪 率 筠 萎 藍 藺 謂 違 遺 韋 猪
ゑ	咲 坐 座 廻 恵 慧 画 穢 衛 隈 面
を	乎 呼 塢 小 少 尾 怨 惋 男 絃 綬 緒 袁 越 遠 雄 鳥 鳴 麻 𠮧
ん	牟
며	㢱 㫆 旀 𣃥
