𪝪	假
𪝱	催
𪞀	光
𪟳	午
𪠉	𱤽
𪡉	呂
𪡍	吝
𪣱	垃
𪤲	声
𪤸	外
𪥾	妬
𪩬	巴
𪫓	律
𪫶	念
𪬫	意
𪮯	揖
𪯊	收
𪰇	日
𪰰	時
𪱕	最
𪲣	某
𪶏	法
𪸄	濫
𪾆	皮
𪿸	磊
𫁞	立
𫆡	育
𫉼	蔑
𫋶	初
𫎑	貝
𫎚	買
𫕸	青
𫡐	乃
𫢖	仍
𫧣	南
𫧦	率
𫴬	対
𫶜	嵩
𬂆	朗
𬂨	村
𬆒	列
𬋆	煉
𬋫	爰
𬋱	爲
𬌣	特
𬎻	產
𬎽	用
𬐸	盧
𬑅	目
𬓗	禄
𬕳	篤
𬕺	篭
𬖩	粦
𬞮	蓮
𬢞	言
𬨻	速
𬪄	那
𬪽	重
𬬃	錦
𭨦	月
